11111111
01111110
11000011
10111101
10111101
11000011
01111110
11111111
*ENTITIES*
1 0 0 0
4 0 7 7
4 0 6 6
4 0 6 7