00000000
11111111
22222222
33333333
44444444
33333333
12344321
00000000
*ENTITIES*
1 0 0 0
4 0 0 0